SO ./textures/S.xpm
WE ./textures/W.xpm
NO ./textures/N.xpm
EA ./textures/E.xpm



F 0,155,0
C 0,0,255

11111111111
10000001111
11100000111
111111N0111
11111111111
