SO ./textures/S.xpm


WE ./textures/W.xpm
NO             ./textures/N.xpm


EA ./textures/E.xpm




F 220,100,0
C 225,30,0

               
1111111111111111
1000000000000001
1000000000000001
1000000000000001
1000000000000001
1000111111111111
1000000000000001
10N0000000000001
1000000000000001
1111111111111111