SO ./textures/S.xpm


WE ./textures/W.xpm
NO             ./textures/N.xpm


EA ./textures/E.xpm




F 220,100,0
C 225,30,0

               
1111111111111111111
1000000000000000001
1000000111111000001
1000000000000000001
100011000N000011001
1000000000000000001
1000000111111000001
1111111111111111111