SO ./textures/S.xpm


WE ./textures/W.xpm
NO ./textures/N.xpm


EA ./textures/E.xpm




F 0,155,0
C 0,0,255

            
1111111111111111
1000000000000001
1000000000000001
1000000000000001
1000000000000001
100000N000000001
1000000000000001
1000000000000001
1000000000000001
11111 111 111111