WE ./textures/W.xpm


C 255,100,100
F 255,50,50

NO ./textures/N.xpm




SO ./textures/S.xpm



dqwdqw
EA ./textures/E.xpm
EA 


dwqdwq

1111111111111111111111111
1000000000110000000000001
1000000000111111111111111
1011000001110000000000001
100100000000000000000000111111111
111111111011000001110000000000001
100000000011000001110111111111111
11110111111111011100000010001
11110111111111011101010010001
1100N000110101011100000010001
10000000000000001100000010001
10000000000000001101010010001
1100000101010101000000000000111
1111011111110101101111010001
11111111111111111111111111