WE ./textures/W.xpm


NO ./textures/N.xpm



C 255,100,100
F 255,50,50

SO ./textures/S.xpm


EA ./textures/E.xpm




1111111111111111111111111
1000000000110000000000001
10000000001
1011000001110000000000001
1001000000000000000000001
111111111011000001110000000000001
100000000011000001110111111111111
11110111111111011100000010001
11110111111111011101010010001
1100N000110101011100000010001
10000000000000001100000010001
10000000000000001101010010001
1100000101010101000000000000111
1111011111110101 101111010001
1111111111111111 111111111111