WE ./textures/W.xpm


C 255,100,100
F 255,50,50

NO ./textures/N.xpm




SO ./textures/S.xpm



EA ./textures/E.xpm


11111
10
1N1
1
