WE ./textures/W.xpm
NO ./textures/N.xpm
SO ./textures/S.xpm
EA ./textures/E.xpm

C 255,100,100
F 255,50,50
8451451248512
1111111111
1000N00001
1000000001
1000000001
1000000001
1000000001
1000000001
1000000001
1000000001
1111111111