WE ./textures/W.xpm
NO ./textures/N.xpm
SO ./textures/S.xpm
EA ./textures/E.xpm

C 255,100,100
F 255,50,50

11111111111111
    1N1
11111111111111