11111111111111
    1N1
11111111111111